
0100100000100000100100111001001100001000
0001011101000000010000000100000000010111
0110000101100001011000010010000000100000
0100000000100000100000000010110000001101
0110000101100001011000010010000000100000
0110000101100001011000010010000000100000





